soc	sóc
lieu	liệu
lien	liên
phieu	phiếu
thuong	thường
thuc	thức
thiet	thiết
ftp	fpt
giay	giấy
thuan	thuận
biet	biết
o%	không
nc	nước
phuc	phúc
ngoc	ngọc
huong	hương
them	thêm
mobistar	mobiistar
lac	lạc
phien	phiên
ket	kết
suat	suất
trk	trước
ol	online
uu	ưu
doc	đốc
trc	trước
dia	mediatek
hien	hiện
coc	cọc
viet	việt
