gop hag : gop hang
gay sf : gay su
thoai mobistar : thoai mobiistar
thi %pin : thi pin
sony xperiax : sony xperia
hd bank : hd bank
chip qualcomm : chip qualcomm
bnh a : binh va
modern combat : modern combat
kq game : ke game
man hjnh : man hinh
ff co : vff co
hang onlie : hang online
hoi ctrinh : hoi trinh
duyet hs : duyet ho
dec dog : dec dong
tra truok : tra truoc
thag gop : thang gop
co cmnd+ : co cmnd
cau hjnh : cau hinh
gorilla glass : gorilla glass
,cho minh : cho minh
luot wed : luot web
bnhieu vay : nhieu vay
xanh navy : xanh nay
anh/ chi : anh chi
xa untra : xa ultra
bao nkiu : bao nhiu
can cmt : can cat
,choi game : choi game
voi snapdragon : voi snapdragon
hom qa : hom qua
tren wed : tren web
lagi binh : lai binh
den flast : den flash
tang dock : tang doc
co cmtnd : co cmnd
nghe fm : nghe am
fai tra : ai tra
may mobistar : may mobiistar
time khong : tim khong
len adroid : len android
minh xjn : minh xin
hay ntn : hay nen
va cmnn : va cmnd
acs thi : ac thi
pluss ban : plus ban
room quoc : rom quoc
halong khong : hang khong
va cmtnd : va cmnd
tx go : tu go
ben hd : ben ho
cua samung : cua samsung
cmnn voi : cmnd voi
zx premium : x premium
tuc ntn : tuc nen
tra ntn : tra nen
bmt khong : bat khong
gia bnhieu : gia nhieu
e hs : e s
virut va : virus va
gop od : gop o
lag ko : la o
vib co : vi co
zi ad : z ad
la qualcomm : ly qualcomm
dung vib : dung vi
mobiitar zumbo : mobiistar zumbo
gop kh : gop kha
wed duoc : web duoc
gop duok : gop duoc
khong pk : khong ak
hang acs : hang acb
nv bao : no bao
,khong biet : khong biet
chip snapdragon : chip snapdragon
tro otg : tro ong
lsao a : sao a
ppt co : fpt co
fpf shop : fpt shop
tag j : tang j
tren zing : tren zing
cua mobistar : cua mobiistar
nen ips : nen ips
hs tra : ho tra
saison co : saigon co
cap otg : cap ong
choi lq : choi la
quan mobi : quan moi
trc minh : tro minh
la bnhieu : la nhieu
koa ban : kha ban
ko xin : kho xin
o tdm : o tam
mobi khong : moi khong
out ra : rut ra
fpt dak : fpt da
o lagi : o lai
ctrinh tra : trinh tra
len adroi : len androi
khong shoop : khong shop
sim ko : sim co
cua vietcombank : cua vietcombank
hds co : hd co
zy ad : z ad
trading phan : trading phan
usb otg : usb otg
chinh acs : chinh xac
khong bik : khong bi
o bmt : o bat
ug dug : ung dung
made in : made in
aqua cua : qua cua
shop ppt : shop fpt
full hd : full hd
tgian nao : gian nao
a/c cho : ac cho
,bay gio : bay gio
sai kh : sai khi
mediatek helio : mediatek helio
shop tx : shop tu
man hih : man hinh
ntn e : nen e
otg khong : ong khong
cmtnd co : cmnd co
op lug : op lung
hang pk : hang k
camer chup : camera chup
smart tv : smart tv
clash of : clash of
mobistar prime : mobiistar prime
ct khuyen : co khuyen
o ftp : o tp
mat cmt : mat cat
qualcomm snapdragon : qualcomm snapdragon
nhug j : nhung j
gta v : gta v
hd sai : he sai
sac zin : sac pin
tang voucher : tang voucher
always on : always on
roi ,ma : roi ma
vay bqt : vay bat
ctrinh do : trinh do
bjo muon : bo muon
giay cmnn : giay cmnd
gear vr : gear vr
hdh co : hd co
samsung galasy : samsung galaxy
cmtnd va : cmnd va
truoc od : truoc o
tra trc : tra truoc
asus zenfon : asus zenfone
tag phieu : tang phieu
sim mobi : sim moi
cung air : cung ai
ty hds : ty bds
mua oline : mua online
of clans : of clans
khong aneu : khong neu
kmai gi : mai gi
icon cua : con cua
samung galaxy : samsung galaxy
cmt goc : cat goc
apple watch : apple watch
cmnn va : cmnd va
otg duoc : ong duoc
samssung galaxy : samsung galaxy
quick charge : quick charge
code giam : code gia
bao nhieu/ : bao nhieu
dung jcb : dung cb
khuen mai : khuyen mai
sony experia : sony xperia
chuog trinh : chuong trinh
dduoc khong : duoc khong
fpt trading : fpt trading
mobistar zumbo : mobiistar zumbo
remi note : redmi note
truoc bnhieu : truoc nhieu
khong zaj : khong a
khong vqtv : khong qtv
cua hds : cua bds
tren website : tren website
vn/a phai : va phai
gpu may : giu may
ko em : co em
co cmnn : co cmnd
e hoj : e hoi
hang ntn : hang nen
suat o% : suat o
tdm binh : tam binh
cmnd+ bang : cmnd bang
kh shop : kg shop
dag xai : dang xai
cmt voi : cat voi
khj nao : khi nao
bmt con : bat con
thog tin : thong tin
zay shop : vay shop
,minh moi : minh moi
mobistar lai : mobiistar lai
